"filename", "language", "JavaScript", "CSS", "HTML", "comment", "blank", "total"
"c:\Users\User\OneDrive - Department of Education and Training\projects\github.io\ai-lunar-lander\index.html", "HTML", 0, 0, 32, 4, 1, 37
"c:\Users\User\OneDrive - Department of Education and Training\projects\github.io\ai-lunar-lander\src\ai\ai-lander.mjs", "JavaScript", 34, 0, 0, 4, 0, 38
"c:\Users\User\OneDrive - Department of Education and Training\projects\github.io\ai-lunar-lander\src\ai\trainer.js", "JavaScript", 91, 0, 0, 17, 21, 129
"c:\Users\User\OneDrive - Department of Education and Training\projects\github.io\ai-lunar-lander\src\config.js", "JavaScript", 23, 0, 0, 0, 0, 23
"c:\Users\User\OneDrive - Department of Education and Training\projects\github.io\ai-lunar-lander\src\index.css", "CSS", 0, 48, 0, 0, 1, 49
"c:\Users\User\OneDrive - Department of Education and Training\projects\github.io\ai-lunar-lander\src\main.js", "JavaScript", 19, 0, 0, 0, 5, 24
"c:\Users\User\OneDrive - Department of Education and Training\projects\github.io\ai-lunar-lander\src\physics\keyboard-lander.js", "JavaScript", 33, 0, 0, 6, 0, 39
"c:\Users\User\OneDrive - Department of Education and Training\projects\github.io\ai-lunar-lander\src\physics\lander.js", "JavaScript", 85, 0, 0, 15, 3, 103
"c:\Users\User\OneDrive - Department of Education and Training\projects\github.io\ai-lunar-lander\src\physics\simulation.js", "JavaScript", 46, 0, 0, 5, 2, 53
"c:\Users\User\OneDrive - Department of Education and Training\projects\github.io\ai-lunar-lander\src\physics\vector.js", "JavaScript", 40, 0, 0, 4, 0, 44
"c:\Users\User\OneDrive - Department of Education and Training\projects\github.io\index.html", "HTML", 0, 0, 1, 0, 1, 2
"Total", "-", 371, 48, 33, 55, 34, 541